WWWWW
W G W
W   W
W   W
W   W
W   W
W   W
W   W
W P W
WWWWW