WWWWWWWWWWWWWWWWWWWWWWWWWWWWWWWWWW
W           P                    W
W        T                    P    W
W                                  W
W                               W           
W       P                    W
W               P                W
W                       W
W                T               W
W    P                           W
W                                   W
W                 P              W
W                                   W
W                   P            W
W                                  W
W   P                            W
W       P              T             W
W                                   W
W           T         P            W
WWWWWWWWWWWWWWWWWWWWWWWWWWWWWWWWWW