WWWWWWWWWWWWWWWWWWW
W              G  W
W   *             W
W            *    W
W         *       W
W  P              W
W                 W
WWWWWWWWWWWWWWWWWWW